###########################
| .                       |
|%%%@%%%%%%%%%%%%%%@      |
|          |%|   |%|%!    |
|          |%|            |
|           .     %%%%!%%%|
|        |%|%||%!         |
|             .           |
|     |%!   %%%%%%%%%%    |
|  .                      |
|%||%!%%%|%|%|   |%|%|!|%||
|           .             |
| |%%|%||%|%%%|%!%||%||%|%|
|          .              |
#!#########################