###########################
|                         |
|   @%%%%%%%%%%%%@        |
|                         |
|                 !       |
|                         |
|             @%%%%%!%%%@%|
|            !            |
|    %%%%%%!              |
|                         |
|           !%%%%%%       |
|                         |
|               %%%%!%@   |
|         %%%%!           |
#########!#####!###########