###########################
|                         |
|   @%%%%%%%%%%%%@    .   |
|          |%|     !%|%|  |
|           .   |%!       |
|         %%%%!%%%        |
|    |%!|                 |
|         .               |
|    .   !%@%%%%%%%%%@    |
|##|%|%|!                 |
|                |%|%|!|%||
|           .             |
|       |%|%%%|%!|        |
|                       . |
#######!###################